# current courses and references
m2 -> "$HOME/Dropbox/Mathematics/Courses/MAT2250-Theorie-des-groupes-2019A"
m2w -> "$HOME/saliola.github.io/maths/teaching/MAT2250-2019A"
m2p -> "$HOME/Dropbox/Mathematics/Courses/MAT2250-Theorie-des-groupes-2014A"

# configuration
bash-conf -> "$HOME/.bash-conf"
tmux-conf -> "$HOME/.tmux-conf"
vim-conf -> "$HOME/.vim"
xmonad -> "$HOME/.xmonad"
jump -> "$HOME/.bash-conf/scripts/jump"
j -> "$HOME/.bash-conf/scripts/jump"

# application directories
apps -> "$HOME/Applications"
sage -> "$HOME/Applications/sage"
itunes-music -> "$HOME/Music/iTunes/iTunes Media/Music"

# download directory
dl -> "$HOME/Downloads"
downloads -> "$HOME/Downloads"

# dropbox
Dropbox -> "$HOME/Dropbox"
cv -> "$HOME/Dropbox/Mathematics/Applications/cv.git"
db -> "$HOME/Dropbox"
dropbox -> "$HOME/Dropbox"
ebooks -> "$HOME/Dropbox/eBooks"
notes -> "$HOME/Dropbox/notes"
math -> "$HOME/Dropbox/Mathematics"
articles -> "$HOME/Dropbox/Mathematics/articles"
courses -> "$HOME/Dropbox/Mathematics/Courses"
grants -> "$HOME/Dropbox/Mathematics/Grants"
projects -> "$HOME/Dropbox/Mathematics/projects"
reviews -> "$HOME/Dropbox/Mathematics/reviews"
talks -> "$HOME/Dropbox/Mathematics/Talks"

website -> "$HOME/website"

# uqam
advising -> "$HOME/Dropbox/uqam/advising"
ev -> "$HOME/Dropbox/uqam/uqam-evaluation-2018"
evaluation -> "$HOME/Dropbox/uqam/uqam-evaluation-2018"
reports -> "$HOME/Dropbox/uqam/reports"
reference-letters -> "$HOME/Dropbox/uqam/recommendation-letters"
recommendation-letters -> "$HOME/Dropbox/uqam/recommendation-letters"
uqam -> "$HOME/Dropbox/uqam"
direction -> "$HOME/Dropbox/uqam/Direction1ercycle"

# organizational
cms -> "$HOME/Dropbox/Mathematics/Conferences/CMS-2018W"
caac -> "$HOME/Dropbox/Mathematics/Conferences/CAAC-2019"

# projects
imm -> "$HOME/Dropbox/Mathematics/articles/Immaculate"
lrb -> "$HOME/Dropbox/Mathematics/articles/lrbs"
pleth -> "$HOME/Dropbox/Mathematics/projects/crystal_pleth"
crystal_pleth -> "$HOME/Dropbox/Mathematics/projects/crystal_pleth"
qmn -> "$HOME/Dropbox/Mathematics/articles/quantum-mn-rule"
r2r -> "$HOME/Dropbox/Mathematics/projects/random-to-random"
